. . . . . . . . . . . . . . . . . . . . # # # # # # # # # . . . . . .
. . . . . . . . . . . . . . . . . . . . # . . . . . . . #  . . . . . .
. . . . . . . . . . . . . . . . . . . . # . . . . . . . # . . . . . .
. . . . . . . . . . . . . . . . . . . . # . . . . . . . # . . . . . .
. . . . . . . . . . . . . . . . . . . . # . . . i . . * # . . . . . .
. . . . . . . . . . . . . . . . . . . . # . . . . . . . # . . . . . .
. . . . . . . . . . . . . . . . . . . . # . . . . . . . # . . . . . .
# # # # # # # # # # # # # # # # # # # # # . . . . # # # # # # # # # #
# . . . . . . . . . . . . . . . . . . . . . . . . . . . . . . . . . #
# . . . . . . . . . . . . . . . . . . . . . . . . . . . . . . . . . #
# . . . . . . . . . . . . . . . . . . . . . . . . . . . . . . . . . #
# . . . . . . . . . . . . . . . . . . . . . . . . . . . . . . . . . #
# * . . . . . . . . . . . . . . . . . . # # # # # # # # # . . . . * #
# . . . . . . . . . . . . . . . . . . . . . . . . . . . . . . . . . #
# . . . . . . . . . . . . . . . . . . . . - . . . . . . . . . . . . #
# . . . . . . . . . . . . . . . . . . . . . . . . . . . . . . . . . #
# . . . . . . . . . . . . . . . . . . . . . . . . . . . . . . . . . #
# # # # # # # # # # . . . . . . . . . # # # # # # # # # # # # # # # #
# . . . . . . . . . . . . . . . . . . . . . . . . . . . . . . . . . #
# . . . . . . . . . . . . . . . . . . . . . . . . . . . . . . . . . #
# . . . . . . . . . . . . . . . . . . . . . . . . . . . . . . . . . #
# . . . . . . . . . . . . . . . . . . . . . . . . . . . . . . . . . #
# . . . . . . . . . . . # # # # # # # . . . . . . . . . . . . . . . #
# . . . . . . . . . . . . . . . . . . . . . . . . . . . . . . . . . #
# . . . . . . . . . . . . . . . . . . . . . . . . . . . . . . . . . #
# . . . . . . . . . . . . . . . . . . . . . . . . . . . . . . . . . #
# . . . . . . . . . . . . . . . . . . . . . . . . . . . . . . . . . #
# * . . . . . . . . # # # # # # # # . . . . . . . . . . . . . . . . #
# . . . . . # # # # # . . . . . . # # # # # # . . . . . . . . . . . #
# # # # # # # . . . . . . * . . . . . . . . # # # # # # . . . . . . #
# . . . . . . . . . . . . . . . . . . . . . . . . . . . . . . . . . #
# . . . . . . . . . . . . . . . . . . . . . . . . . . . . . . # # # #
# . . . . . . . . . . . . . . . . . . . . . . . . . . . . . . . . . #
# . . . . . . . . . . . # # # # . . . . . . . . . . . . . . . . . . #
# . . . . . . . . . . . . . . . . . . . . . . . . . . . . . . . . * #
# . . . . . . . . . . . . . . . . . . . . . . . . . . . . . . . . . #
# . . . . . . # # # # . . . . . . # # # # . . . . . . . . # # # # # #
# . . . . . . . . . . . . . . . . . . . . . . . . . . . . . . . . . .
# c l . . . . . . . . . . . . . . . . . . . . # # # # . . . . . . . .
# . . . . . . . . . . . . . . . . . . . . . . . . . . . . . . . . . .
# # # # # # . . . . . . . . . . . . . . . . . . . . . . . . . . . . .
. . . . . . . . . . . . . . . . . . . . . . . . . . . . . . . . . . .
. . . . . . . . . . . . . . . . . . . . . . . . . . . . . . . . . . .
. . . . . . . . . . . . . . d . . . . . . . . . . . . . . . . . . . .