# # # # # # # # # # # # # # # # # # # # #
# . . . . . . . . . . . . . . . . . . . #
# . - c . . . . . . . . . . . . . . . . #
# . . . . . . . . . . . . . . . . . . . #
# # # # # . . . . . . . . . . . . . p . #
# . . . . . . . # # # # . . . . . . . . #
# . . . . . . . . l . . . . . # # # # # #
# . . . . . . . . . . . . . . . . . . . #
# . . . . . . . . . . # # # # . . . . . #
# . . . . . # # # # . . . . . . . . . . #
# . . . . . . . . . . . . . . . . . . . #
# # # # # . . . . . . . . . . . . . . . #
. . . . . . . . . . . . . . . . . . . . .
. . . . . . . . . . . . . . . . . . . . .
. . . . . . . . . d . . . . . . . . . . .
