# # # # # # # # # # # # # # # # # # # # #
# . . . . . . . . . # . . . . . . . . . #
# . . . . . . . . . # . . . . . . . . . #
# . . . . . . . . . # . . . . . . . p . #
# . . . . . . . . . # . . . . . . . . . #
# . . . . . . . . . # . . . . . # # # # #
# . . . . . . . . . # . . . . . . . . . #
# # # # # # . . . . # . . . . . . . . . #
# . . . . . . . . . # . . . . . . . . . #
# . . . . . . . . . # . . . . . . . . . #
# . . . . . . . # # # # # # . . . . . . #
# . . . . . . . . . . . . . . . . . . . #
# . . . . . . . . . . . . . . . . . . . #
# . . . . . . . . . . . . . . . . # # # #
# . . . . . . . . . l . . . . . . . . . #
# . . . . . . . . . . . . . . . . . . . #
# . . . # # # # . . . . . . # # # # # . #
# . . . . . . . . . # # # . . . . . . . #
# . . . . . . . . . . . . . . . . . . . #
. . . . . . . . . . . . . . . . . . . . .
. . . . . . . . . . . . . . . . . . . . .
. . . . . . . . . . . . . . . . . . . . .
. . . . . . . . . d . . . . . . . . . . .
