# # # # # # # # # # # # # # # # # # # # #
# . . . . . . . . . . . . . . . . . . . #
# . . . . . . . . . . . . . . . . . . . #
# . . . . . . . . . . . . . . . . . . . #
# . . . . . . . . . . . . . . . . . . . #
# . p . . . . . . . l . . . . . . . . . #
# . . . . . . . . . . . . . . . . . . . #
# # # # # # . . . . . . . . . # # # # # #
# . . . . # # # . . . . . # # # . . . . #
# . . . . . . # # # . # # # . . . . . . #
# . . . . . . . . # # # . . . . . . . . #
# # # # # # # # # # # # # # # # # # # # # 
. . . . . . . . . . . . . . . . . . . . .
. . . . . . . . . . . . . . . . . . . . .
