. . . . . . . . . . . . . . . . . . . .
# # # # # # # # # # # # # # # # # # # #
# . . . . . . . . . . . . . . . . . . #
# . . . . . . . . . . . . . . . . . . #
# . . . . . . . . . . . . . . . . . . #
# . . . . . . . . . l . . . . . . . . #
# e . . . . . . . . . . . . . . . . . #
# # # # # # # # # # # # # # # # # # # #
